0 0 0 0 0 0 0 0 0 0
1 1 1 1 1 1 1 1 1 1
2 2 2 4 2 1 3 5 5 3
2 4 2 2 4 1 3 3 3 3
4 4 4 4 4 1 4 4 4 4
4 2 2 4 2 1 3 5 5 5
2 2 2 4 4 i 1 3 g 3 3 5
7 a 7 a 7 a 7 c 7 i 1 7 7 7 7
0 0 0 0 0 0 0 0 0 0
0 0 0 0 0 0 0 0 0 0

lunasol.jpg